7,5,6,1,1,1,1,3,7,0
7,4,4,1,1,1,1,3,7,0
7,1,1,1,1,1,1,3,7,0
7,1,1,1,1,3,1,3,7,0
7,1,1,3,3,3,1,1,7,0
7,1,1,1,1,1,1,1,7,0
7,1,1,1,1,1,1,1,7,0
7,1,1,1,1,1,1,1,7,0
7,1,3,1,3,3,1,1,7,0
7,3,3,3,1,3,3,1,7,0