0,0,0,0,0,0,0,0,0,0
0,0,0,0,0,0,0,0,0,0
0,3,1,3,1,3,1,3,0,0
0,3,2,3,2,3,2,3,0,0
0,3,2,3,2,3,2,3,0,0
0,1,7,1,7,1,7,1,0,0
0,1,1,1,1,1,1,1,0,0
0,1,1,1,5,1,1,4,0,0
0,0,0,0,0,0,0,0,0,0
0,0,0,0,0,0,0,0,0,0