0,0,0,0,0,0,0,0,0,0
0,0,0,0,0,0,0,0,0,0
0,5,2,0,0,3,3,0,0,0
0,1,2,0,0,3,3,0,0,0
0,1,0,0,0,0,0,0,0,0
0,3,3,0,0,1,1,0,0,0
0,3,3,0,0,1,6,0,0,0
0,3,3,0,0,0,0,0,0,0
0,0,0,0,0,0,0,0,0,0
0,0,0,0,0,0,0,0,0,0