0,0,0,0,0,0,0,0,0,0
0,7,2,1,1,1,1,1,7,0
0,2,2,1,1,1,1,1,1,0
0,1,1,1,1,1,3,1,1,0
0,1,1,1,6,1,1,1,1,0
0,1,3,2,1,1,1,6,1,0
0,1,1,3,1,1,1,1,1,0
0,1,1,1,6,1,1,1,1,0
0,5,1,1,1,3,7,2,2,0
0,0,0,0,0,0,0,0,0,0