0,0,0,0,0,0,0,0,0,0
0,0,0,0,0,0,0,0,0,0
0,0,5,1,1,1,3,3,3,0
0,0,1,1,6,1,1,6,3,0
0,0,1,1,1,1,1,2,3,0
0,0,1,2,2,1,1,1,1,0
0,0,3,7,3,1,1,6,1,0
0,0,3,3,3,1,1,1,1,0
0,0,0,0,0,0,0,0,0,0
0,0,0,0,0,0,0,0,0,0